{
    "numX": 13,
    "numY": 10,
    "size": [64, 64],
    "start": [32, 32],
    "tileNames": ["", "ProtoCoin", "ProtoBox", "ProtoBat", "Tile01", "Tile02", "Tile03"],
    "tiles": [0, 0, 0, 0, 0, 1, 1, 1, 0, 0, 0, 0, 0,
              0, 0, 0, 0, 0, 1, 1, 1, 0, 0, 0, 1, 1,
              0, 4, 4, 0, 0, 0, 0, 0, 0, 0, 0, 4, 4,
              0, 0, 0, 0, 0, 0, 0, 0, 0, 0, 0, 0, 0,
              1, 0, 0, 0, 6, 5, 5, 5, 6, 0, 0, 1, 0,
              4, 0, 0, 0, 0, 0, 0, 0, 2, 0, 0, 0, 4,
              0, 4, 4, 2, 0, 0, 0, 0, 2, 0, 0, 4, 4,
              3, 0, 3, 2, 0, 0, 0, 0, 2, 0, 4, 4, 4,
              0, 1, 0, 2, 0, 0, 0, 0, 2, 4, 4, 4, 4,
              5, 6, 6, 6, 6, 6, 6, 6, 6, 4, 4, 4, 4]
}